##########################################################################
#..................................#.....................................#
#.........#........................#########.........#################...#
#.........#...........##########...........#.........................#...#
##..###...#...........#........#####.......#.........................#...#
#.....#...#...........#..............................................#...#
#.....#...#############..#######...######..###########################...#
#.....#........................#...#..........#......#...................#
#.....###################......#...#..........#..........................#
#...........#..................#...#..........#......#...................#
#...........#...........#......#####.................#.......#...........#
#...........##########..#..........############......#.......#...........#
#...........#...........#............................#.......#...........#
#...........#...........##############################.......#...........#
#...........#................................................#...........#
#...........#........................................#.......#...........#
#.#########...##########.............................#.......#...........#
#.###################################................#.......#...........#
#......................##############................#...#####...........#
#......................#.............................#...................#
#....................................................#...................#
##########################################################################

